##############
#--#--##---###
##-#-##--#--##
##-#-##-##---#
#----##----###
#-#-##---#-###
#-#----#-----#
#---#-#--#--##
##############
