##########
#--#--##-#
##-#-##--#
##-#-##-##
#----##--#
#-#-##---#
#-#----#-#
#---#-#--#
##########
